1,0,0,0,0,0,0,0,0,0,0,0,0,0,0,0,0,0,0,0,0,0,0,0,0,0,0,0,0,0,0,3
1,0,0,0,0,0,0,0,0,0,0,0,0,0,0,0,0,0,0,0,0,0,0,0,0,0,0,0,0,0,5,0
1,0,0,0,0,0,0,0,0,0,0,0,0,0,0,0,0,0,0,0,0,0,0,0,0,0,0,0,4,4,4,4
1,0,0,0,0,0,0,0,0,0,0,0,0,0,0,0,0,0,0,0,0,0,0,0,4,4,4,0,1,2,2,3
1,0,0,0,0,0,0,0,0,0,0,0,0,0,0,0,0,0,0,0,0,0,0,0,1,2,3,0,0,0,0,3
1,0,0,0,0,0,0,0,0,0,0,0,0,0,0,0,0,0,0,0,4,4,4,0,0,0,0,0,0,0,0,3
1,0,0,0,0,0,0,0,0,0,0,0,0,0,0,0,0,0,0,0,1,2,3,0,0,0,0,0,0,0,0,3
1,0,0,0,0,0,0,0,0,0,0,0,0,0,0,0,0,0,0,0,0,0,0,0,0,0,0,0,0,0,0,3
1,0,0,0,0,6,4,0,0,4,4,0,0,4,4,0,0,4,0,0,0,0,0,0,0,0,0,0,0,0,0,3
1,0,0,0,0,1,3,0,0,1,3,0,0,1,3,0,0,2,0,0,0,0,0,0,0,0,0,0,0,0,0,3
1,0,0,0,0,0,0,0,0,0,0,0,0,0,0,0,0,0,0,0,0,0,0,0,0,0,0,0,0,0,0,3
1,0,0,4,0,0,0,0,0,0,0,0,0,0,0,0,0,0,0,0,0,0,0,0,0,0,0,0,0,0,0,3
1,0,0,2,0,0,0,0,0,0,0,0,0,0,0,0,0,0,0,0,0,0,0,0,0,0,0,0,0,0,0,3
1,4,0,0,0,0,0,0,0,0,0,4,0,0,0,0,4,0,0,0,0,0,0,0,0,0,0,0,0,0,0,3
1,3,0,0,0,0,0,0,0,0,0,1,4,6,4,6,3,0,0,0,0,0,0,0,0,0,0,0,0,0,0,3
1,3,6,4,4,4,0,0,0,0,0,1,2,2,2,2,3,0,0,0,0,0,0,0,0,0,0,0,0,0,0,3
1,2,2,2,2,3,0,0,4,4,0,0,0,0,0,0,0,0,0,0,0,0,0,0,0,0,0,0,0,0,0,3
1,0,0,0,0,0,0,0,1,3,0,0,0,0,0,0,0,0,0,4,4,6,4,0,0,0,0,4,4,4,4,3
1,0,0,0,0,0,0,0,0,0,0,0,0,0,0,0,0,0,0,2,2,2,3,0,0,0,0,1,2,2,2,3
1,0,0,0,0,0,0,0,0,0,0,0,0,0,4,4,6,4,4,2,2,2,3,0,0,0,0,1,2,2,2,3
1,0,0,0,0,0,0,0,0,0,0,0,0,0,1,2,2,2,2,2,2,2,3,0,0,0,0,1,2,2,2,3
1,4,4,4,4,4,4,4,4,4,4,4,0,0,1,2,2,2,2,2,2,2,3,0,0,0,0,1,2,2,2,3
1,2,2,2,2,2,2,2,2,2,2,3,0,0,1,2,2,2,2,2,2,2,3,0,0,0,0,1,2,2,2,3
1,2,2,2,2,2,2,2,2,2,2,3,0,0,1,2,2,2,2,2,2,2,3,0,0,0,0,1,2,2,2,3